11111111111
100C0000001
1E1000000P1
11111111111
