11111111111
100C0000001
1E1000101P1
11111111111
